Textures:
textures/debugTexture.png textures/debugTexture.norm.png textures/default_roughness.png textures/default_metallic.png textures/default_ao.png
textures/TreeStump.png textures/default_norm.png textures/default_roughness.png textures/default_metallic.png textures/default_ao.png
StaticMeshes:
models/TreeTri.obj
Entities:
0 B -28.5 -21.5 0 28.5 21.5 0 1 0 0 0 0 1 0 0 0 0 1 0 2.5 6.5 0 1 
1 0 1 0 0 0 0 1 0 0 0 0 1 0 6.88931 2.5358 0 1 
0 B -1.5 -7.5 -9 1.5 7.5 9 1 0 0 0 0 1 0 0 0 0 1 0 12.5 3.5 9 1 
0 B -10 -2 -9 10 2 9 1 0 0 0 0 1 0 0 0 0 1 0 4 13 9 1 
0 B -1.5 -9.5 -9 1.5 9.5 9 1 0 0 0 0 1 0 0 0 0 1 0 -7.5 5.5 9 1 
0 B -11.5 -1 -9 11.5 1 9 1 0 0 0 0 1 0 0 0 0 1 0 2.5 -5 9 1 
0 B -11.5 -10.5 -3.5 11.5 10.5 3.5 1 0 0 0 0 1 0 0 0 0 1 0 2.5 4.5 21.5 1 
1 0 1 0 0 0 0 1 0 0 0 0 1 0 -1.73007 1.77414 0 1 
1 0 1 0 0 0 0 1 0 0 0 0 1 0 1.21387 6.48794 9.53674e-07 1 
1 0 1 0 0 0 0 1 0 0 0 0 1 0 7.76068 8.87719 9.53674e-07 1 
1 0 1 0 0 0 0 1 0 0 0 0 1 0 3.20863 1.46072 -9.53674e-07 1 
1 0 1 0 0 0 0 1 0 0 0 0 1 0 0.326075 -1.70449 9.53674e-07 1 
1 0 1 0 0 0 0 1 0 0 0 0 1 0 -4.30764 7.96218 0 1 
1 0 1 0 0 0 0 1 0 0 0 0 1 0 4.32539 5.65345 -9.53674e-07 1 
1 0 1 0 0 0 0 1 0 0 0 0 1 0 -3.5512 4.60066 9.53674e-07 1 
1 0 1 0 0 0 0 1 0 0 0 0 1 0 -3.60893 -2.2797 0 1 
1 0 1 0 0 0 0 1 0 0 0 0 1 0 4.05828 -1.59397 0 1 
1 0 1 0 0 0 0 1 0 0 0 0 1 0 7.76117 -0.723778 -9.53674e-07 1 
1 0 1 0 0 0 0 1 0 0 0 0 1 0 8.80025 3.82606 -9.53674e-07 1 
1 0 1 0 0 0 0 1 0 0 0 0 1 0 4.2841 8.94495 -1.90735e-06 1 
1 0 1 0 0 0 0 1 0 0 0 0 1 0 -1.19591 8.50905 -1.90735e-06 1 
