Textures:
images/white.png textures/default_norm.png textures/default_roughness.png textures/default_metallic.png textures/default_ao.png
textures/AK_103.png textures/AK_103.norm.png textures/AK_103.rough.png textures/AK_103.metal.png textures/default_ao.png
textures/bamboo-wood-semigloss.png textures/bamboo-wood-semigloss.norm.png textures/bamboo-wood-semigloss.rough.png textures/bamboo-wood-semigloss.metal.png textures/bamboo-wood-semigloss.ao.png
textures/Iberian_Blue_Ceramic_Tiles.png textures/Iberian_Blue_Ceramic_Tiles.norm.png textures/Iberian_Blue_Ceramic_Tiles.rough.png textures/default_metallic.png textures/default_ao.png
textures/marble.jpg textures/marble.norm.png textures/default_roughness.png textures/default_metallic.png textures/default_ao.png
textures/scuffed-plastic.png textures/scuffed-plastic.norm.png textures/scuffed-plastic.rough.png textures/scuffed-plastic.metal.png textures/scuffed-plastic.ao.png
textures/streaked-marble.png textures/streaked-marble.norm.png textures/streaked-marble.rough.png textures/streaked-marble.metal.png textures/default_ao.png
StaticMeshes:
models/AK47.obj
models/Slab.obj
models/ToyCar.obj
models/UVBall.obj
Entities:
3 B -17 -16 -0.5 17 16 0.5 1 0 0 0 0 1 0 0 0 0 1 0 3 4 0.5 1 
6 2 5.96046e-08 -1 0 0 1 5.96046e-08 0 0 0 0 1 0 4 3 1 1 RCCar 
6 1 1 0 0 0 0 1 0 0 0 0 1 0 -1 19 1 1 
6 1 1 0 0 0 0 1 0 0 0 0 1 0 1 19 1 1 
6 1 1 0 0 0 0 1 0 0 0 0 1 0 -3 19 1 1 
6 1 1 0 0 0 0 1 0 0 0 0 1 0 -5 19 1 1 
6 1 1 0 0 0 0 1 0 0 0 0 1 0 -7 19 1 1 
6 1 1 0 0 0 0 1 0 0 0 0 1 0 -7 17 1 1 
6 1 1 0 0 0 0 1 0 0 0 0 1 0 -5 17 1 1 
6 1 1 0 0 0 0 1 0 0 0 0 1 0 -3 17 1 1 
6 1 1 0 0 0 0 1 0 0 0 0 1 0 -1 17 1 1 
6 1 1 0 0 0 0 1 0 0 0 0 1 0 1 17 1 1 
6 1 1 0 0 0 0 1 0 0 0 0 1 0 3 17 1 1 
6 1 1 0 0 0 0 1 0 0 0 0 1 0 3 19 1 1 
6 1 1 0 0 0 0 1 0 0 0 0 1 0 5 19 1 1 
6 1 1 0 0 0 0 1 0 0 0 0 1 0 7 19 1 1 
6 1 1 0 0 0 0 1 0 0 0 0 1 0 5 17 1 1 
6 1 1 0 0 0 0 1 0 0 0 0 1 0 7 17 1 1 
6 1 1 0 0 0 0 1 0 0 0 0 1 0 9 17 1 1 
6 1 1 0 0 0 0 1 0 0 0 0 1 0 9 19 1 1 
6 1 1 0 0 0 0 1 0 0 0 0 1 0 11 19 1 1 
6 1 1 0 0 0 0 1 0 0 0 0 1 0 11 17 1 1 
6 1 1 0 0 0 0 1 0 0 0 0 1 0 13 17 1 1 
6 1 1 0 0 0 0 1 0 0 0 0 1 0 13 19 1 1 
6 1 1 0 0 0 0 1 0 0 0 0 1 0 15 19 1 1 
6 1 1 0 0 0 0 1 0 0 0 0 1 0 15 17 1 1 
6 1 1 0 0 0 0 1 0 0 0 0 1 0 17 17 1 1 
6 1 1 0 0 0 0 1 0 0 0 0 1 0 17 19 1 1 
6 1 1 0 0 0 0 1 0 0 0 0 1 0 19 17 1 1 
6 1 1 0 0 0 0 1 0 0 0 0 1 0 19 19 1 1 
6 1 1 0 0 0 0 1 0 0 0 0 1 0 -9 17 1 1 
6 1 1 0 0 0 0 1 0 0 0 0 1 0 -9 19 1 1 
6 1 1 0 0 0 0 1 0 0 0 0 1 0 -11 17 1 1 
6 1 1 0 0 0 0 1 0 0 0 0 1 0 -11 19 1 1 
6 1 1 0 0 0 0 1 0 0 0 0 1 0 -13 17 1 1 
6 1 1 0 0 0 0 1 0 0 0 0 1 0 -13 19 1 1 
5 3 4 0 0 0 0 4 0 0 0 0 0.617672 0 -7 3 1 1 
2 1 3.2 0 0 0 0 3.2 0 0 0 0 3.2 0 15 3 1 1 
1 0 8.3 0 0 0 0 8.3 0 0 0 0 8.3 0 19 3 5.5 1 
4 1 1 0 0 0 0 1 0 0 0 0 1 0 -13 -11 1 1 
4 1 1 0 0 0 0 1 0 0 0 0 1 0 -13 -9 1 1 
4 1 1 0 0 0 0 1 0 0 0 0 1 0 -11 -9 1 1 
4 1 1 0 0 0 0 1 0 0 0 0 1 0 -11 -11 1 1 
4 1 1 0 0 0 0 1 0 0 0 0 1 0 -9 -9 1 1 
4 1 1 0 0 0 0 1 0 0 0 0 1 0 -9 -11 1 1 
4 1 1 0 0 0 0 1 0 0 0 0 1 0 -7 -9 1 1 
4 1 1 0 0 0 0 1 0 0 0 0 1 0 -7 -11 1 1 
4 1 1 0 0 0 0 1 0 0 0 0 1 0 -5 -9 1 1 
4 1 1 0 0 0 0 1 0 0 0 0 1 0 -5 -11 1 1 
4 1 1 0 0 0 0 1 0 0 0 0 1 0 19 -11 1 1 
4 1 1 0 0 0 0 1 0 0 0 0 1 0 19 -9 1 1 
4 1 1 0 0 0 0 1 0 0 0 0 1 0 17 -9 1 1 
4 1 1 0 0 0 0 1 0 0 0 0 1 0 17 -11 1 1 
4 1 1 0 0 0 0 1 0 0 0 0 1 0 15 -9 1 1 
4 1 1 0 0 0 0 1 0 0 0 0 1 0 15 -11 1 1 
4 1 1 0 0 0 0 1 0 0 0 0 1 0 13 -9 1 1 
4 1 1 0 0 0 0 1 0 0 0 0 1 0 13 -11 1 1 
4 1 1 0 0 0 0 1 0 0 0 0 1 0 11 -9 1 1 
4 1 1 0 0 0 0 1 0 0 0 0 1 0 11 -11 1 1 
4 1 1 0 0 0 0 1 0 0 0 0 1 0 -3 -11 1 1 
4 1 1 0 0 0 0 1 0 0 0 0 1 0 1 -11 1 1 
4 1 1 0 0 0 0 1 0 0 0 0 1 0 5 -11 1 1 
4 1 1 0 0 0 0 1 0 0 0 0 1 0 9 -11 1 1 
4 1 1 0 0 0 0 1 0 0 0 0 1 0 7 -11 1 1 
4 1 1 0 0 0 0 1 0 0 0 0 1 0 -1 -11 1 1 
4 1 1 0 0 0 0 1 0 0 0 0 1 0 3 -11 1 1 
4 1 1 0 0 0 0 1 0 0 0 0 1 0 -3 -9 1 1 
4 1 1 0 0 0 0 1 0 0 0 0 1 0 1 -9 1 1 
4 1 1 0 0 0 0 1 0 0 0 0 1 0 5 -9 1 1 
4 1 1 0 0 0 0 1 0 0 0 0 1 0 9 -9 1 1 
4 1 1 0 0 0 0 1 0 0 0 0 1 0 7 -9 1 1 
4 1 1 0 0 0 0 1 0 0 0 0 1 0 3 -9 1 1 
4 1 1 0 0 0 0 1 0 0 0 0 1 0 -1 -9 1 1 
0 3 1 8.67386e-06 0.000927394 0 8.67386e-06 0.999825 -0.0187042 0 -0.000927394 0.0187042 0.999825 0 4 3 4 1 
